111111111111111111111111111111111111111111111111111111
100000P000C0C0C0C0C0C000000000000000000000000000000011
100E0000000000E000000000000000000000000000000000E00011
10C000000000000000000000000000000000C00000000000000011
11111110000E00000000C0E0000000011111111111111111110001
1C11000000000000000111111111111111111111110000000001C1
1000000000011111111111111C00000000000CCCCC111111111111
1111111111000000000000000000000CCCCCCCC110000000000001
1000000000000000000000E0000000CCCCCCCCCCCCCCC110000001
1CCCCCCC100000000000E00000000111111110000E000001111111
1000000000000000000000000000000000000000CCCCCCCCCCCC11
1CCCCC1111111111111111111111111111111111C1111111111111
111111111111111111111111111111111111111111111111111111